10 50
280 3100
0 0 0 0 0 0 0 0 0 0
5 5 5 5 5 5 5 5 5 5
3 3 3 3 3 3 3 3 3 3
1 1 1 1 1 1 1 1 1 1
2 2 2 2 2 2 2 2 2 2
0 0 0 0 0 0 0 0 0 0
2 2 2 2 2 2 2 2 2 2
1 1 1 1 1 1 1 1 1 1
0 0 0 0 0 0 0 0 0 0
3 3 3 3 3 3 3 3 3 3
5 5 5 5 5 5 5 5 5 5
3 3 3 3 3 3 3 3 3 3
4 4 4 4 4 4 4 4 4 4
5 5 5 5 5 5 5 5 5 5
5 5 5 5 5 5 5 5 5 5
4 4 4 4 4 4 4 4 4 4
0 0 0 0 0 0 0 0 0 0
3 3 3 3 3 3 3 3 3 3
3 3 3 3 3 3 3 3 3 3
0 0 0 0 0 0 0 0 0 0
2 2 2 2 2 2 2 2 2 2
2 2 2 2 2 2 2 2 2 2
4 4 4 4 4 4 4 4 4 4
1 1 1 1 1 1 1 1 1 1
1 1 1 1 1 1 1 1 1 1
0 0 0 0 0 0 0 0 0 0
2 2 2 2 2 2 2 2 2 2
3 3 3 3 3 3 3 3 3 3
3 3 3 3 3 3 3 3 3 3
2 2 2 2 2 2 2 2 2 2
0 0 0 0 0 0 0 0 0 0
3 3 3 3 3 3 3 3 3 3
2 2 2 2 2 2 2 2 2 2
0 0 0 0 0 0 0 0 0 0
2 2 2 2 2 2 2 2 2 2
3 3 3 3 3 3 3 3 3 3
4 4 4 4 4 4 4 4 4 4
5 5 5 5 5 5 5 5 5 5
4 4 4 4 4 4 4 4 4 4
1 1 1 1 1 1 1 1 1 1
0 0 0 0 0 0 0 0 0 0
3 3 3 3 3 3 3 3 3 3
3 3 3 3 3 3 3 3 3 3
3 3 3 3 3 3 3 3 3 3
4 4 4 4 4 4 4 4 4 4
1 1 1 1 1 1 1 1 1 1
0 0 0 0 0 0 0 0 0 0
3 3 3 3 3 3 3 3 3 3
3 3 3 3 3 3 3 3 3 3
0 0 0 0 0 0 0 0 0 0